#..............#
#..............#
#..............#
#..............#
#..............#
#..............#
#......#.......#
#..............#
################